00011111111000000000
11001110001000000000
11001110101000111111
11001110101000100001
11000000101000101001
11111111101111101001
11100000001000101001
11101111111010101001
11101100000010101001
11101101111110101001
11101101111110101001
11100001111110001000
11111111111111111110